R 900 900

SO ./texture/texture_2.xpm
NO ./texture/texture_1.xpm
EA ./texture/texture_3.xpm
WE ./texture/texture_4.xpm
S  ./texture/texture_obj.xpm

C 200,0,15
F 0,200,10

11111111111
10E00102001     1111
12000000201111111001
10000000000000000001
11100000001111111111
1111111111111111