R 640 480
SO ./texture/texture_2.xpm
NO ./texture/texture_1.xpm
EA ./texture/texture_3.xpm
WE ./texture/texture_4.xpm
S  ./texture/texture_obj.xpm
F 110,153,15 
C 255,255,255

        1111111111111111111111111
        1110000000000000000000001
        1110000000000000000000001
111111111000000000000000000000001
1000000000000000E0000000000001111
10000000000000000000000000001
10000000000000000000000000001
10000000000000000000000000001
10000000000000000000000000001
10000000000000000001010000001
11000001110101011111011110101
11110111 1110121 101111010001
11111111 1111111 111111111111
